%%%%%%
%   .%
% % o%
%P   %
%%%%%%
